1111111111111111111111111111111111111
1000100010001000100010001000100010001
1010101010101010101010101010101010101
1010101010101010101010101010101010101
1010101010101010101010101010101010101
101010101010101010101010101010101010
101010101C101010101010101010101010101
1010101010101010101010101010101010101
1P100010001000100010001000100010001E1
1111111111111111111111111111111111111
